611118711111111111-
441444144441111111-
181714141141111811-
141414141141111111-
141414141141111111-
141414141141171111-
148414141141111111-
144414771144111111-
111111111111111111