 R010| R012|    0|    0|    0|    0|    0|    0|    0|    0|    0|    0|    0|    0|    0|    0|    0|    0|    0|    0|    0|    0|    0|    0|    0|    0|    0|    0|    0|  0-
 R011| R013|    0|    0|    0|    0|    0|    0|    0|    0|    0|    0|    0|    0|    0|    0|    0|    0|    0|    0|    0|    0|    0|    0|    0|    0|    0|    0|    0|  0-
    0|    0|    0|    0|    0|    0|    0|    0|    0|    0|    0|    0|    0|    0|    0|    0|    0|    0|    0|    0|    0|    0|    0|    0|    0|    0|    0|    0|    0|  0-
    0|    0|    0|    0|    0|    0|    0|    0|    0|    0|    0|    0|    0| H010|    0|    0|    0|    0|    0|    0|    0|    0|    0|    0|    0|    0|    0|    0|    0|  0-
    0|    0|    0|    0|    0| H010|    0|    0|    0|    0|    0|    0|    0|    0|    0|    0|    0|    0|    0|    0|    0|    0|    0|    0|    0|    0|    0|    0|    0|  0-
    0|    0|    0|    0|    0|    0|    0|    0|    0|    0|    0|    0|    0|    0|    0|    0|    0|    0|    0|    0|    0|    0|    0| H010|    0|    0|    0|    0|    0|  0-
    0|    0|    0| H010|    0|    0|    0|    0|    0|    0|    0|    0|    0|    0|    0|    0|    0|    0|    0|    0|    0|    0|    0|    0|    0|    0|    0|    0|    0|  0-
    0|    0|    0|    0|    0|    0|    0|    0|    0| R020| R022| R024|    0|    0|    0| W010| W012|    0| R010| R012|    0|    0|    0|    0|    0|    0|    0|    0|    0|  0-
    0|    0|    0|    0|    0|    0|    0|    0|    0| R021| R023| R025|    0|    0|    0| W011| W013|    0| R011| R013|    0|    0|    0|    0|    0|    0|    0|    0|    0|  0-
    0|    0|    0| W010| W012|    0|    0| C010|    0|    0|    0|    0|    0|    0|    0|    0|    0|    0|    0|    0|    0|    0|    0|    0|    0|    0|    0|    0|    0|  0-
    0|    0|    0| W011| W013|    0|    0|    0|    0|    0|    0| C010|    0|    0|    0|    0|    0|    0|    0|    0|    0|    0|    0|    0|    0|    0|    0|    0|    0|  0-
    0|    0|    0|    0|    0|    0|    0|    0|    0|    0|    0|    0|    0|    0|    0|    0|    0|    0|    0|    0|    0|    0|    0|    0|    0|    0|    0|    0|    0|  0-
    0|    0|    0|    0|    0|    0|    0|    0|    0|    0|    0|    0|    0|    0|    0|    0|    0|    0|    0|    0|    0|    0|    0|    0|    0|    0|    0|    0|    0|  0-
    0|    0|    0|    0|    0|    0|    0|    0|    0|    0|    0|    0|    0|    0|    0|    0|    0|    0|    0|    0|    0|    0|    0|    0|    0|    0|    0|    0|    0|  0-
    0|    0|    0|    0|    0|    0|    0|    0|    0|    0|    0|    0|    0|    0|    0|    0|    0|    0|    0|    0|    0|    0|    0|    0|    0|    0|    0|    0|    0|  0-
    0|    0|    0|    0|    0|    0|    0|    0|    0|    0|    0|    0|    0|    0|    0|    0|    0|    0|    0|    0|    0|    0|    0|    0|    0|    0|    0|    0|    0|  0-
    0|    0|    0|    0|    0|    0|    0|    0|    0|    0|    0|    0|    0|    0|    0|    0|    0|    0|    0|    0|    0|    0|    0|    0|    0|    0|    0|    0|    0|  0