111111111111111111-
441444144441111111-
141414141141111111-
141414141141111111-
141414141141111111-
141414141141111111-
141414141141111111-
144414441144111111-
111111111111111111