611118711311641714611118711312-
441444144441111719611118711313-
781794121161117811611118711321-
141414141141118111611118711316-
341424144141115119611118711319-
141414141141171811611118711318-
147814141141111116611118711319-
144414771144111111611118711317-
121411476211819111611118711315-
141414141141113111611118711316-
121411476211819111611118711311-
141414141141113111611118711312-
121411476211819111611118711313-
141414141141113111611118711314-
121411476211819111611118711315-
141414141141113111611118711316-
278414771144111319161111871317